000000000000000000000000000000000000000000000000000000000000000000000000000000000000000321111112333333330000000000000000000000000000000
000000000000000000000000000000000000000000000000000333333000000000000000000000000000003321111112233222233333300000000000000000000000000
000000000000000000000000000000000033333300000000333322223330000000000000000000000033333221111111222211222222300000033333300000000000000
000000000000000000000000000000003332222330000033322221122233333330000003333333000032222211111111221111121112333333332222300000000000000
000000000000000000000000003333333222112230333332221111111223222230000003222223330332112211111111221111111112222233222112333000000000000
000000000000000000033333303222233211111233322222111111111122211230333333211122230322112111111111222111111112211222211112223330000000000
000000000000000000032222303211222211111222221111111121111122111233322222211111233321111111111111112111111111111111111111122230000000000
000000000000000000032112333211221111111121121111111111211211111222221112111111222221111111111111111111111121111111111111111230000000000
000000000000000000032112222211221111111111111111111111111211211121121111111111122112111111111111111111111111111111111111111233333000000
000000000000000003332112112211111111121111111111111111111111111111111111111111121111111111111111111111112111111111111111111222223000000
000000000000000003222111111111111111111111111111111111111111111111111111111111121111111111121111111111111112112111111112111221123000000
000000000000000333211111111111111111111111111111111111111111111111111111111111111111111111211111111112111111111111111111111211123000000
000000000000000322211112111111111111111111111111111211111111111211121111111111111111111111111111111111112111111111111111111111123300000
000000000000000321111111111111111111111111111111111111121111111111111111111111111122111111111111111111111111111111111112111111222300000
000000000000000321111111111111111111111111111121111111111111111111111111112111111111111111112111111211111111111111121111111111112300000
000000000000000321111111121111111111111111111111111111111111112111111111111111111111111111111111111111111111111111111111111111112300000
000000000000000321111111111112111111111111111111111111111111111111111111111111111111211111111111111111111111111111111111111111222300000
000000000000000321111111111111111111111111111111111111111111111111111211111111111111111111111111111111111111111111111211111111123300000
000000000000000322112111111111111111111111111111111111121111111111111111111111111111111111111111111111111111111111111111111111123000000
000000000033333321111111111111111121111111111111111111111111121111111111111111111111211111111111111111111111111111111111111111223000000
000000003332222221111111111111111111111111111111111111111111111111111111111111111111111111111111111111111111111112111111111111233333000
000000003222112211111111111112111111111111111111121111111111111111111121111111111111111111111111111111111111111111111111111111222223000
000000033211111111111111111111111121111111111211111111111111111111111111111121111111111111111111111111111111111111111111111111111123330
000003332211111111111111111111111111111111111111111111111111111111111111111111111111111111111111111111111111111111111111111111111122230
000003222111111111111111111111111111111111111111111111111111211111111111111111111111111111111111111111111111111111111111111111111111230
000033211111111111111111111111111111111111111111111111111111111111111111111111111111111111111111111111111121111111112111111111111111230
000032211111111111111111111111111111111111111111111111111111111111111111111111111112111111111111111111111111111121111111111111111112230
000032111111111111111111111121111111111111111111111111111111112111111111111111111111111111111111111111111111111111111111111111111222330
000032111111111111111111111111111111111111111111111111111111111111111111111111111111111111111111112111111111111111111111111111112233300
000032111111111121111111111111111111111111111111111111111111111111111111111111111111111111111111111111111111111111121111111111222330000
000032111112111111111111112111111112111111111111111111111112112111111111111111111111111111111111121121121111111111111111111111233300000
000032221122111111111111111111111111111111111111111111111111111111111111111111111111111111111111111111111111111111111111121111223000000
000033321121111111111111111111111111111111211112111111111111111111111112111111111111211112111111111111111111111111111111111111123300000
000000321111111111111111111111111111111111111111111111121111111111111111111111111111111111111111111111111111121111111111111111122333000
000000321111111111111111111111111111111111111111111111111111111111111111111111211111111111111111111111111111111111121111111111112223000
000000322111111111111111111111111112111121111112111111111121111111111111111111111111111111111111111111111111111121111111111111111123000
000000332111111111111111111111111111121121111111111111111111111111111111111111111111111111111111211111111111111111111111111111121123330
000000322111111111111111111111111111111111111111111111111111111111111111111121111111111111111111111111111111111111111111111111111122230
000000321111111111111111111111121111111111111111111111111111111111111111111111111112111112111111111111111211111111111111111111111111230
000000321111111111111211111111111111111111111111121111111111111111111111111111111111111111111111111111111111111111121111111111111211230
000033322111111112111111111111111111111211111111111111111111111111111111111121111111111111111111111111111111211111111111211211111111230
000332222111111111111111111111111111111111111111111111111111111111111111111111111111111111111111111111111112112111111111111111111111230
000322112221111111111111111111111111111111211211111111111111111111111111111112111111111111111111111111111111111111111111111111211112230
000321112111111112111111111111111111111112111111121111111111111111111211111111111111121111111112111111111111111111111111111111111222330
000321111111111111111111111111111111111111111111111111111111111111111111111111112111111111111111112111111111211112111111111111111222300
000322111111111111111111111111111211111111111121111111111111111111111121111111111111111111111111111111111111111111111111111112111112300
000321112111111112111111111111111111111111111111111111111111111111121111111111111111111111121111111112111111111111111111111112111112300
000321112111111111111111111111111111111111111111111111111111111111111111111221111111111111111121111111121111111111111111112111111222300
000321111111111111111112111111111211111111111111111111111111111111111111111111111121111111111111111111111111111111111211111111112233300
000321111111111211111111111111111111111111111111111111111121111111111111111111111111111111111111111111111111111111111111111111112330000
000321111111111111111111111111111111111111111111111111112111111111211122111111111211111111111111111111111111111111211111111111222233000
000322211111111111111111111111111111111111211111111111211111111111222222111111111111211111111111111111111111111111111211111111211223000
000333211111111111112111111111111111111111111121111111111121111111122232211211111111111111111111111111111112111111111111111111111123000
000003211111111111111111111111111111111111111111111111111121111111111233211211122222111111111111111111111111111111111111111111111123000
000003221121111111111111111111111111111111111112111111111121111111111233211221123321111111111111111111111111111111111111111111111223000
000003322221111111111111121111111111111111111111111111111111111111111233222222223321111111111111111111111211211111111111111111122233000
000003322211111111111111111111111111111111111111111112111111111111111233333333333322111121111111111111111111111111111111111112223333000
000003221111111111211111111111111111111111111211111111111111111121111230000000000332111111111111111111111111111111111111111111122223000
000003211111111111111111111211111111112111111111111111111111211111111230000000000032221111111111111111111111111112111111111111111123000
000003211111111111111111111111111211111111111111111111121111111111112230000000000033322211111111112111121111111111111112111111111123330
000003211112111111211111111111111111111111111111111111111111111111112330000000000033332111111111111111111111111111111111111111111122233
000003221111111111111111111111111111111111111121111111111111111211222300000000000032222111111111111111111111111111111111111111111111222
000003321111111111111111111111111111111111111111111111121111111112233300000000000032112111111111111111111112112111111111121111111111112
000000322211111111111111111111111111111111111111111111111111111112230000000000000032111111111111111111111112111111121111111111111111112
000000321111111111112111121111111111111111112111111111111111121111230000000000000032111111111111111111111111111111111111111111111111112
000000321111111111111111111111111111111111111111111111121111111111230000000000000032211111111111121111111111111111111111111111111112222
000000321111111111121111111111111111111111111111111111121111111111230000000000000033222111111111111111111111111111111211111111111211223
000000322211111111111121111111111111111111111111111111111111121122230000000000003333332111111111211111111111111111111111111111111111123
000000332111112111111111111111111111111111111111111111111111112223330000000033333222222111111111121111111112111111111111111111111111123
000000032111111111111111111111111112111121111111111111111111112333333333000032222211211111111111111111111111111111111111111111111111122
000000332211111111111111111111111111111112111211111111111211122223322223303332111111111111111121111111111111111111121111111111111111111
000000322211111111111111111121111111111111111111111111111111121123321122303222111111111111111111111111111111111112111111111111111111111
000000321111111111111111111111111111111111112111111111111111111122221112333211111111111111111111111111111111111111111111111111111111111
000000321111111111111211111111111211112111111111111111111111111111211112322211111111111111111111111111111112111111111111121111111111111
000000321111111111111111111121111111111111111111111111111111111111111122221111111111111111111111111111111111111211111121111111111222222
000000321121112111111111111111111111111111111111111111111111111111111211111111111111111111111111111111111111111111111111111111112233333
000000322211111111111111111111111111211111111111111111111111111111111111111111111111111111121111111111111111111111111111111111111230000
000003333211111111111111112111111111111111121121111111112112221111111111111111111111111111111111111111111111111111111111111111111230000
000003222221111111111111111111111111111111111111111111111122222111211211111121121111111111111111111111111111111111111111111211211230000
000003211221121111111111111111111111111211211111111111111111111111111111111111111111111211111111111111111121111111111211211211222230000
000003211111121111111111111111211111111111111111111111111111111111111111111111111111111111111111111111111211111111111111111111223330000
000033211111111111111111111111111112111111111111121111211111111111111111111111111111111111111111111111111111111111111111111111122230000
333332222111111111111111111111111211111111111111111111111111111111111111111111111111111111111111111111111111211111111111111111111233333
222222111111111111111111111111111211111111111111111111111111111111111111111111111111111121111111111111111111111111111111111111111222222
111111111111111111111121111111111112111112111111111111111111111111111111111111111111111111111111121111111111111111111111111111111111112
111111111111111121111111111111111111111111111121111111111111111111111111111111111111111111111111111111111111112111111112111111111111111
221111111111111122111111111111111111111111111111111111111112111111111111111111111111211111121112111121111111111111111111111111211112111
322211111111111111111111111111111111111111111111111111111111111111111111111111111111111111111111111111111111111111111111111111111111112
322111111111111111111111111111111111111111111111111111111111111111111111111111111111111111111121111111111211211111111211111111111111112
321111111111112111111112111111111111111211111111111112111112111111111111111111111111111111111112111111111111111111111111111121111111222
321111111111111211111111111111111111111111111111111111211111111111111111111111111111111111112111111111111111111111111111111111111122233
222111111111111111111111111111111111111111111111111111111111111111111211111111111111111111111111111121111112112111111111111111111122330
211211111111111111111111111111111111111111111111111111111111111112111111111111111111111111111211111111111111111111111111111111111112330
211111111111111111111111111111111111111111111111111111111111111111111111111111111111111121111111111111111111111111121111111111111112233
211111111111111111111111111112111111111111111111111111111111111111111111111111111111111111111111111121111111121111111111111111111111223
222112111111111111111111111111111111111111111111111111111111111111111111111111111111111111111111111111111111111111111111111111111111123
332222211111111111111111111111111111111121111111121111111211111111111121111112111111111121111111111111111111111121111111111111111111122
033333221111111111111111111121121111111111111111111111111111111111111111111111111111111111111111111111111111111211111111111111111111111
000003321111111111111111111111111111111211111111111111111111111111111111111111111111111111111111111111111111111111111111111111111111111
000000322112111111111111111111111111111111111111111111111111111111111111111111111111111111111111111111111111111111111111111111111121111
000000332222111111111111111111111111111111111111121111111111111111111111111111211211111111121111111111111111111111111111111111112211122
000000033332111111111112111111111111111111111111111111211111211112111111111111111111111111111111111111111111111111111111111111112211123
000000003332111111111111111211111111111111111121112111111111111111111121111211111111111111211111111111111111111111111111111112112222223
000000033222111111111111111111111111111211111111111111111111111111111111111111211111111111111111111111111111111111111111111122111233333
000000032211111111111111111111111111111111111111111111111111211111121111111111111111211111111111111111111111111111111111111122111230000
000000032111111111111121111111111111111111111121111111111211111111111111111111121111111111111111111111111111111111111111111122112230000
000000032111111112111111111111111111111111111111111111111111111111111111111111111111111111111111111111111111111111111111111111222330000
000003332221111221121111111111111111111111111111111111111111112111111111111111111111211111111111111111111111111111111111111111233330000
000003222111112111111111111111111111111121111111211111111111111111111111111111111111111111111111111111111111111111111111111122222230000
000003211111122111111111211111111111111111111111211112111111111111111111111111211111111111111111111111111111112111111111111111111230000
000003211112222111111111111121111112111111111111111111111121121111111111111111111111111111111111111111121111111111211111121111111230000
000003211222332221111111111111111111111111111111111111111111111111111111111111121111111111121111111111111111111111111111122112112230000
000003222233333211111111111111111111111111111111111112111111111111111111111111111111111111111111111111111111111111111111122222222330000
000003333330033211111111111112111111111111111111111111111111111111111111111111111111111111111111111111111111111112221111223333333300000
000000000000032211111111111111111111111111111111111111111111111111111111111111121111111111111111111111111111111111222222233000000000000
000000000000032111111111111111111111112111111112111211111111111111111111111211111111111111111111111111111111111111123333330000000000000
000000000000032111111111111121111111111111111111111111111111111111111111111111111111111111111111111111111111111111123000000000000000000
000000000000032222112111111111111111111111111121111111111111111211111111211111111111112111111111111111111111111122223000000000000000000
000000000000033332211111111112111112111111111111111111111111111111111111111111111111111121111111111111111111211123333000000000000000000
000000000000000033211112111111111111111111111111111111112111111111111111111111111111111111111111111111111111211223000000000000000000000
000000000000000003211211111111111111111111111111111111111111111111111111111111111111111111111111111111111211222233000000000000000000000
000000000000000003222211111111111111121111111111111111111111111111111111111111121111112111111111111111111222233330000000000000000000000
000000000000000003333221122211111121111111111111112111111111112111111111111111121112211111111112111112111112330000000000000000000000000
000000000000000000003321123221111221111111111122222112111111111111112211111211121112211111111112111112111112300000000000000000000000000
000000000000000000000322223321111222222111211112332222111122111221122211111211222222222111111112112112211222300000000000000000000000000
000000000000000000000333333322222233321111211112333332211122111111123222112211123333332111111222222222222233300000000000000000000000000
000000000000000000000000000333333330321112221112300033222222111112223332222211123000032221111233333333333330000000000000000000000000000
000000000000000000000000000000000000322112321112300003333332222222333033333222223000033322211230000000000000000000000000000000000000000
