111111111
111111111
110000011
110000011
111101111
100101001
111101111
