00000000000000000000000000000000000000000000000000000000000000000000000000000000000000000000000000000000000000000000000000000000000000000000
00000000000000000000000000000000000000000000000000000000000000000000000000000000000000000000000000000000000000000000000000000000000000000000
00000000000000000000000000000000000000000000000000000000000000000000000000000000000000000000000000000000000000000000000000000000000000000000
00000000000000000000000000000000000000000000000000000000000000000000000000000000000000000000000000000000000000000000000000000000000000000000
00000000000000000000000000000000000000000000000000000000000000000000000000000000000000000000000000000000000000000000000000000000000000000000
00000000000000000000000000000000000000000000000000000000000000000000000000000000000000000000000000000000000000000000000000000000000000000000
00000000000000000000000000000000000000000000000000000000000000000000000000000000000000000011111100000000000000000000000000000000000000000000
00000000000000000000000000000000000000000000000000000000000000000000000000000000000000000011111100000000000000000000000000000000000000000000
00000000000000000000000000000000000000000000000000000000000000000000000000000000000000000011111110000110000000000000000000000000000000000000
00000000000000000000000000000000000000000000000000000011000000000000000000000000000000000111111110011111011100000000000000000000000000000000
00000000000000000000000000000000000001100000000000011111110000000000000000000000000001100111111110011111111100000000001100000000000000000000
00000000000000000000000000000000000111110000000001111111111000110000000000111000000001101111111110001111111100110000111100000000000000000000
00000000000000000000000000000110000111110000011111111011111001110000000000111110000011111111111111101111111111111111111111000000000000000000
00000000000000000000001100000110011111111011011111111110110111110000011101111110000011111111111111111111111011111111111111110000000000000000
00000000000000000000001100000110011111111111111111111111110110111011011111111111001101111111111111111111111111111111111111110000000000000000
00000000000000000000001101100111111111011111111111111111111111111111111111111111011111111111111111111111101111111111111111110000000000000000
00000000000000000000001111111111111111111111111111111111111111111111111111111111011111111111011111111111111101101111111101110011000000000000
00000000000000000000111111111111111111111111111111111111111111111111111111111111111111111110111111111101111111111111111111110111000000000000
00000000000000000000111101111111111111111111111111110111111111110111011111111111111111111111111111111111101111111111111111111111000000000000
00000000000000000011111111111111111111111111111111111111011111111111111111111111111001111111111111111111111111111111111101111110000000000000
00000000000000000011111111111111111111111111111011111111111111111111111111101111111111111111101111110111111111111111011111111111100000000000
00000000000000000011111111011111111111111111111111111111111111101111111111111111111111111111111111111111111111111111111111111111100000000000
00000000000000000011111111111101111111111111111111111111111111111111111111111111111110111111111111111111111111111111111111111110000000000000
00000000000000000011111111111111111111111111111111111111111111111111110111111111111111111111111111111111111111111111110111111111000000000000
00000000000000000001101111111111111111111111111111111111011111111111111111111111111111111111111111111111111111111111111111111111000000000000
00000000000000000011111111111111111011111111111111111111111111011111111111111111111110111111111111111111111111111111111111111110000000000000
00000000000000000011111111111111111111111111111111111111111111111111111111111111111111111111111111111111111111111101111111111110000000000000
00000000000001100111111111111101111111111111111111011111111111111111111011111111111111111111111111111111111111111111111111111110000000000000
00000000000111111111111111111111111011111111110111111111111111111111111111111011111111111111111111111111111111111111111111111111111000000000
00000000000111111111111111111111111111111111111111111111111111111111111111111111111111111111111111111111111111111111111111111111111000000000
00000000001111111111111111111111111111111111111111111111111110111111111111111111111111111111111111111111111111111111111111111111111110000000
00000000111111111111111111111111111111111111111111111111111111111111111111111111111111111111111111111111111011111111101111111111111110000000
00000000111111111111111111111111111111111111111111111111111111111111111111111111111101111111111111111111111111111011111111111111111100000000
00000001111111111111111111111011111111111111111111111111111111101111111111111111111111111111111111111111111111111111111111111111110000000000
00000001111111111111111111111111111111111111111111111111111111111111111111111111111111111111111111101111111111111111111111111111100000000000
00000001111111111011111111111111111111111111111111111111111111111111111111111111111111111111111111111111111111111111011111111110000000000000
00000001111101111111111111101111111101111111111111111111111101101111111111111111111111111111111111011011011111111111111111111110000000000000
00000000011001111111111111111111111111111111111111111111111111111111111111111111111111111111111111111111111111111111111111011110000000000000
00000000011011111111111111111111111111111110111101111111111111111111111101111111111110111101111111111111111111111111111111111111000000000000
00000000011111111111111111111111111111111111111111111111011111111111111111111111111111111111111111111111111111011111111111111111000000000000
00000000011111111111111111111111111111111111111111111111111111111111111111111110111111111111111111111111111111111111011111111111100000000000
00000000001111111111111111111111111101111011111101111111111011111111111111111111111111111111111111111111111111111011111111111111111000000000
00000000001111111111111111111111111111011011111111111111111111111111111111111111111111111111111110111111111111111111111111111111011000000000
00000000001111111111111111111111111111111111111111111111111111111111111111111011111111111111111111111111111111111111111111111111111000000000
00000000011111111111111111111111011111111111111111111111111111111111111111111111111101111101111111111111110111111111111111111111111110000000
00000000011111111111110111111111111111111111111111011111111111111111111111111111111111111111111111111111111111111111011111111111110110000000
00000000001111111101111111111111111111110111111111111111111111111111111111111011111111111111111111111111111110111111111110110111111110000000
00000000001111111111111111111111111111111111111111111111111111111111111111111111111111111111111111111111111101101111111111111111111110000000
00000001100011111111111111111111111111111110110111111111111111111111111111111101111111111111111111111111111111111111111111111110111100000000
00000011101111111101111111111111111111111101111111011111111111111111110111111111111111011111111101111111111111111111111111111111110000000000
00000011111111111111111111111111111111111111111111111111111111111111111111111111101111111111111111101111111110111101111111111111110000000000
00000001111111111111111111111111110111111111111011111111111111111111111011111111111111111111111111111111111111111111111111111101111100000000
00000011101111111101111111111111111111111111111111111111111111111111011111111111111111111111011111111101111111111111111111111101111100000000
00000011101111111111111111111111111111111111111111111111111111111111111111110011111111111111111011111111011111111111111111101111110000000000
00000011111111111111111101111111110111111111111111111111111111111111111111111111111011111111111111111111111111111111110111111111100000000000
00000011111111110111111111111111111111111111111111111111111011111111111111111111111111111111111111111111111111111111111111111111100000000000
00000011111111111111111111111111111111111111111111111111101111111110111001111111110111111111111111111111111111111110111111111110000000000000
00000000111111111111111111111111111111111110111111111110111111111110000001111111111110111111111111111111111111111111110111111110110000000000
00000000111111111111101111111111111111111111111011111111111011111111000000110111111111111111111111111111111101111111111111111111111000000000
00000000111111111111111111111111111111111111111111111111111011111111110000110111000001111111111111111111111111111111111111111111111000000000
00000000011011111111111111111111111111111111111101111111111011111111110000110011000011111111111111111111111111111111111111111111110000000000
00000000000011111111111111011111111111111111111111111111111111111111110000000000000011111111111111111111110110111111111111111111000000000000
00000000000111111111111111111111111111111111111111111101111111111111110000000000000001111011111111111111111111111111111111111100000000000000
00000000011111111110111111111111111111111111110111111111111111111011110000000000000001111111111111111111111111111111111111111111000000000000
00000000111111111111111111110111111111101111111111111111111110111111110000000000000000011111111111111111111111111101111111111111111000000000
00000000111111111111111111111111110111111111111111111111011111111111100000000000000000000111111111101111011111111111111101111111111000000000
00000000111101111110111111111111111111111111111111111111111111111111100000000000000000001111111111111111111111111111111111111111111000000000
00000000011111111111111111111111111111111111111011111111111111110110000000000000000000001111111111111111111111111111111111111111111110000000
00000000011111111111111111111111111111111111111111111111011111111100000000000000000001101111111111111111111101101111111111011111111111100000
00000000000111111111111111111111111111111111111111111111111111111100000000000000000001111111111111111111111101111111011111111111111111100000
00000000011111111111101111011111111111111111101111111111111111011110000000000000000001111111111111111111111111111111111111111111111111100000
00000000011111111111111111111111111111111111111111111111011111111110000000000000000000111111111111011111111111111111111111111111111100000000
00000000011111111111011111111111111111111111111111111111011111111110000000000000000000001111111111111111111111111111110111111111110110000000
00000000000111111111111011111111111111111111111111111111111111011000000000000000000000001111111110111111111111111111111111111111111111000000
00000000001111101111111111111111111111111111111111111111111111100000000000000000000000001111111111011111111101111111111111111111111111000000
00000000001111111111111111111111111101111011111111111111111111100000000000000000000110111111111111111111111111111111111111111111111111000000
00000000000111111111111111111111111111111101110111111111110111000000000000000001111111111111111011111111111111111111011111111111111111110000
00000000000111111111111111111011111111111111111111111111111111011000011000000001111111111111111111111111111111111101111111111111111111110000
00000000011111111111111111111111111111111111101111111111111111111000011100000111111111111111111111111111111111111111111111111111111111110000
00000000011111111111110111111111110111101111111111111111111111111110111100000111111111111111111111111111111101111111111111011111111111110000
00000000011111111111111111111011111111111111111111111111111111111111111000011111111111111111111111111111111111110111111011111111110000000000
00000000011011101111111111111111111111111111111111111111111111111111110111111111111111111111111111111111111111111111111111111111100000000000
00000000000111111111111111111111111110111111111111111111111111111111111111111111111111111111011111111111111111111111111111111111110000000000
00000000000111111111111111101111111111111111011011111111101100011111111111111111111111111111111111111111111111111111111111111111110000000000
00000000000011111111111111111111111111111111111111111111111000001110110111111011011111111111111111111111111111111111111111110110110000000000
00000000110011011111111111111111111111110110111111111111111111111111111111111111111111110111111111111111111011111111110110110110000000000000
00000000111111011111111111111110111111111111111111111111111111111111111111111111111111111111111111111111110111111111111111111110000000000000
00000000111111111111111111111111111101111111111111011110111111111111111111111111111111111111111111111111111111111111111111111111000000000000
00000000001111111111111111111111110111111111111111111111111111111111111111111111111111111111111111111111111110111111111111111111110000000000
00000001111111111111111111111111110111111111111111111111111111111111111111111111111111111011111111111111111111111111111111111111110000000000
01111111111111111111111011111111111101111101111111111111111111111111111111111111111111111111111111011111111111111111111111111111111111100000
01111111111111111011111111111111111111111111111011111111111111111111111111111111111111111111111111111111111111101111111101111111111111110000
00011111111111111001111111111111111111111111111111111111111101111111111111111111111110111111011101111011111111111111111111111110111101110000
00000111111111111111111111111111111111111111111111111111111111111111111111111111111111111111111111111111111111111111111111111111111111100000
00001111111111111111111111111111111111111111111111111111111111111111111111111111111111111111111011111111110110111111110111111111111111100000
00011111111111101111111101111111111111110111111111111101111101111111111111111111111111111111111101111111111111111111111111111011111110000000
00011111111111110111111111111111111111111111111111111110111111111111111111111111111111111111101111111111111111111111111111111111111000000000
00001111111111111111111111111111111111111111111111111111111111111111110111111111111111111111111111111011111101101111111111111111111000000000
00110111111111111111111111111111111111111111111111111111111111111101111111111111111111111111110111111111111111111111111111111111111100000000
00111111111111111111111111111111111111111111111111111111111111111111111111111111111111111011111111111111111111111111011111111111111100000000
00111111111111111111111111111101111111111111111111111111111111111111111111111111111111111111111111111011111111011111111111111111111110000000
00001101111111111111111111111111111111111111111111111111111111111111111111111111111111111111111111111111111111111111111111111111111111000000
00000000111111111111111111111111111111111011111111011111110111111111111011111101111111111011111111111111111111111011111111111111111111000000
00000000011111111111111111111011011111111111111111111111111111111111111111111111111111111111111111111111111111110111111111111111111111110000
00000000011111111111111111111111111111110111111111111111111111111111111111111111111111111111111111111111111111111111111111111111111111110000
00000000001101111111111111111111111111111111111111111111111111111111111111111111111111111111111111111111111111111111111111111111111011110000
00000000000001111111111111111111111111111111111111011111111111111111111111111110110111111111011111111111111111111111111111111111100111000000
00000000000001111111111101111111111111111111111111111110111110111101111111111111111111111111111111111111111111111111111111111111100111000000
00000000000001111111111111110111111111111111111011101111111111111111111011110111111111111110111111111111111111111111111111111101100000000000
00000000000001111111111111111111111111110111111111111111111111111111111111111110111111111111111111111111111111111111111111111001110000000000
00000000000111111111111111111111111111111111111111111111111110111111011111111111111110111111111111111111111111111111111111111001110000000000
00000000001111111111111011111111111111111111111011111111110111111111111111111111011111111111111111111111111111111111111111111001100000000000
00000000001111111101111111111111111111111111111111111111111111111111111111111111111111111111111111111111111111111111111111111110000000000000
00000000000011110011011111111111111111111111111111111111111111101111111111111111111110111111111111111111111111111111111111111110000000000000
00000000001111101111111111111111111111111011111110111111111111111111111111111111111111111111111111111111111111111111111111111000000000000000
00000000111111001111111110111111111111111111111110111101111111111111111111111110111111111111111111111111111111101111111111111111110000000000
00000000111100001111111111111011111101111111111111111111111011011111111111111111111111111111111111111111011111111110111111011111110000000000
00000000110000000011111111111111111111111111111111111111111111111111111111111111011111111111011111111111111111111111111111001101100000000000
00000000000000000111111111111111111111111111111111111101111111111111111111111111111111111111111111111111111111111111111111000000000000000000
00000000000000000111111111111101111111111111111111111111111111111111111111111111111111111111111111111111111111111100011110000000000000000000
00000000000000000111111111111111111111111111111111111111111111111111111111111111011111111111111111111111111111111110000000000000000000000000
00000000000000001111111111111111111111101111111101110111111111111111111111110111111111111111111111111111111111111111000000000000000000000000
00000000000000001111111111111011111111111111111111111111111111111111111111111111111111111111111111111111111111111111000000000000000000000000
00000000000000000001101111111111111111111111111011111111111111110111111110111111111111101111111111111111111111111000000000000000000000000000
00000000000000000000111111111101111101111111111111111111111111111111111111111111111111111011111111111111111110111000000000000000000000000000
00000000000000000000111101111111111111111111111111111111101111111111111111111111111111111111111111111111111110110000000000000000000000000000
00000000000000000000110111111111111111111111111111111111111111111111111111111111111111111111111111111111110110000000000000000000000000000000
00000000000000000000000111111111111111011111111111111111111111111111111111111111011111101111111111111111110000000000000000000000000000000000
00000000000000000000000011000111111011111111111111101111111111101111111111111111011100111111111101111101111100000000000000000000000000000000
00000000000000000000000011000011110011111111111000001101111111111111100111110111011100111111111101111101111100000000000000000000000000000000
00000000000000000000000000000011110000001110111100000001111001110011000111110110000000001111111101101100110000000000000000000000000000000000
00000000000000000000000000000000000000011110111100000000111001111111000001100111000000001111110000000000000000000000000000000000000000000000
00000000000000000000000000000000000000011100011100000000000001111100000000000111000000000011110000000000000000000000000000000000000000000000
00000000000000000000000000000000000000001100011100000000000000000000000000000000000000000000110000000000000000000000000000000000000000000000
00000000000000000000000000000000000000000000000000000000000000000000000000000000000000000000000000000000000000000000000000000000000000000000
00000000000000000000000000000000000000000000000000000000000000000000000000000000000000000000000000000000000000000000000000000000000000000000
00000000000000000000000000000000000000000000000000000000000000000000000000000000000000000000000000000000000000000000000000000000000000000000
00000000000000000000000000000000000000000000000000000000000000000000000000000000000000000000000000000000000000000000000000000000000000000000
00000000000000000000000000000000000000000000000000000000000000000000000000000000000000000000000000000000000000000000000000000000000000000000
00000000000000000000000000000000000000000000000000000000000000000000000000000000000000000000000000000000000000000000000000000000000000000000
